#############
#&..........#
#.#.####..#.#
#.#..#.##.#.#
#.##...#...##
#....###.#..#
###...#..##.#
#@##.#...#..#
#....#...#.##
#..#.#.#.#.##
##.#.#.#.#..#
#..#...##..##
#############