##########
#&.......#
#.#.####.#
#.#..#.#.#
#.##...#.#
#....###.#
###...#..#
#@##.#...#
#....#...#
##########